11111111111111111111
10000100000000000001
10000100000000000001
10000000000001000001
10000000000001000001
11111111111111000001
10000000000000000001
10000000000000000001
10000000000000000001
10000010000001111111
10000010000000000001
10000010000000000001
11111110000000000001
10000000000000000001
10000000000000000001
10000011111111100001
10000000000000100001
10000000000000100001
10000000000000100001
11111111111111111111