11111111111111111111
10001000000000000001
10001000000000000001
10001000000000000001
10001000000000000001
10001000000000000001
10001000000000000001
10001000000000000001
10001000000000000001
10001000000100000001
10001000000100000001
10001000000100000001
10000000000100000001
10000000000100000001
10000000000100000001
10000000000100000001
10000000000100000001
10000000000100000001
10000000000100000001
11111111111111111111