11111111111111111111
10000010000001000001
10000010000001000001
10000010000001000001
10000011000011000001
10000000000000000001
10000000000000000001
11111111000011111111
10000001000010000001
10000000000000000001
10000000000000000001
10000000000000000001
10000000000000000001
10000001000010000001
11111111000011111111
10000000000000000001
10000000000000000001
10000000000000000001
10000000000000000001
11111111111111111111